XXXXXXXXXX
X___XX_X_X
X_X__X___X
XSXX___X_X
X_X__X___X
X___XX_X_X
X_X__X_X_X
X__G_X___X
XXXXXXXXXX

XXXXX
XS__X
X___X
X__GX
XXXXX

XXXXXXXX
XS_____X
X______X
X______X
X______X
X______X
X_____GX
XXXXXXXX

XXXXXXXXXXXXXXX
X_____________X
X_XXXXXXXXXXX_X
XS_XXXXXXXXXX_X
XX__________X_X
XXXXXXXXXXX_X_X
X___________X_X
X_XXXXXXXXXXX_X
X____________GX
XXXXXXXXXXXXXXX

XXXXXXXXXXXXXXXXXXX
XXXXX_XXXXXXXXXXXXX
XXXX_X_XXXXXXXXXXXX
XXXSXXX_XXXXXXXXXXX
XXXX_XXX_XXXXXXXXXX
XXXXX_XXX_XXXXXXXXX
XXXXXX_XXX________X
X_____XXXXXXXXXXX_X
X_XXXXXXXXXXXXXX__X
X______________G_XX
XXXXXXXXXXXXXXXXXXX

XXXXXXXXXXXXXXXXXXX
XXX___XXXXXXXXXXXXX
XX_XXX_XXXXXXXXXXXX
XXXSXXX_XXXXXXXXXXX
XXXX_XXX_XXXXXXXXXX
XXXX__XXX_XXXXXXXXX
XXXXXX_XXX________X
XXXX__XXXXXXXXXXX_X
X_X_XXXXXXXXXXXX__X
X______________G_XX
XXXXXXXXXXXXXXXXXXX
